{
    "width":34,
    "height":29,
    "start":[18,16],
    "end":[15,16],
    "board":[[4,7,1,6,5,5,5,7,1,6,3,6,5,5,5,7,1,6,5,3,6,3,6,5,5,3,4,5,3],
    [6,9,6,9,6,5,1,12,3,10,12,9,6,5,3,14,1,10,2,10,8,14,13,5,3,12,5,7,9],
    [10,6,9,6,13,5,5,5,9,12,5,1,10,2,12,9,6,9,10,10,6,9,6,1,12,5,3,10,2],
    [10,10,6,9,2,6,5,5,5,3,6,5,9,14,3,2,10,6,9,10,10,6,13,3,2,6,11,12,9],
    [10,10,14,3,10,10,4,5,3,12,9,6,7,9,12,11,10,10,6,9,10,10,2,10,12,9,12,5,3],
    [10,10,10,12,9,14,5,3,12,5,3,10,12,5,3,10,10,10,14,5,11,14,9,12,5,3,6,3,10],
    [10,10,12,5,3,12,3,10,6,5,13,9,6,1,10,10,10,10,10,4,11,12,7,3,2,10,10,12,9],
    [10,12,5,3,10,2,10,10,10,2,4,5,13,3,10,8,10,10,12,3,12,3,10,10,10,10,12,5,1],
    [12,7,3,10,10,10,10,10,10,10,6,5,3,10,12,5,9,14,3,10,6,9,10,12,9,12,5,5,3],
    [6,11,10,10,12,13,9,10,10,10,10,2,10,12,7,5,5,9,10,10,10,6,9,6,3,4,7,1,10],
    [10,10,10,12,7,5,1,10,12,11,10,10,10,4,15,5,5,1,10,10,8,10,2,10,12,3,10,6,9],
    [10,10,8,6,11,6,5,9,2,10,10,10,12,3,10,6,7,3,10,12,5,9,10,10,2,12,13,9,2],
    [10,12,5,9,10,10,6,5,11,10,10,12,3,10,8,10,8,10,12,5,5,7,9,12,15,3,2,6,11],
    [12,7,5,3,10,10,10,4,13,9,10,6,9,12,5,9,6,9,6,5,3,10,6,3,8,10,10,10,10],
    [4,13,1,10,10,10,12,5,3,6,9,12,3,6,3,2,10,6,9,2,10,10,10,12,5,9,12,9,10],
    [4,5,5,9,8,12,5,3,12,9,6,5,13,9,12,9,8,10,6,9,12,13,9,6,5,5,5,5,9],
    [4,5,5,5,5,5,5,13,5,5,13,5,5,5,5,5,5,13,13,5,5,7,5,13,5,5,5,5,1],
    [4,5,5,5,5,5,7,5,5,5,5,5,5,5,5,5,5,5,5,5,5,13,5,5,5,5,5,5,1],
    [6,5,7,5,5,1,10,2,6,7,5,1,6,3,4,3,2,6,5,3,2,4,5,5,3,6,1,6,3],
    [12,1,12,5,7,3,10,10,8,12,5,5,9,12,5,11,14,9,4,13,13,5,3,2,12,13,5,9,10],
    [6,5,5,3,10,10,10,14,5,5,3,4,5,7,1,10,14,5,5,5,7,1,10,10,4,5,5,3,10],
    [10,6,1,10,10,10,10,8,6,3,10,6,5,15,5,9,10,6,5,1,10,2,12,11,6,5,7,13,9],
    [10,14,3,10,10,10,12,3,10,10,12,9,2,10,6,5,13,11,6,5,9,12,5,11,10,2,14,3,2],
    [12,9,10,10,8,12,5,11,10,12,7,5,9,10,10,6,3,8,12,5,5,5,3,8,10,10,10,12,9],
    [6,1,10,12,3,6,5,9,10,2,12,5,3,10,8,10,12,7,1,6,5,3,12,5,9,12,15,5,3],
    [14,5,11,2,10,10,6,1,10,14,5,3,10,12,5,9,6,13,7,9,6,15,5,5,1,6,11,6,9],
    [10,6,9,10,10,10,14,3,10,14,1,10,12,5,5,3,12,1,10,2,10,10,2,6,5,9,8,14,3],
    [8,10,2,14,13,9,10,12,13,9,4,9,6,5,3,10,6,5,11,10,10,10,12,11,6,5,3,10,10],
    [6,9,12,9,6,5,9,6,1,6,5,3,8,6,13,9,10,4,13,9,10,14,3,8,10,2,14,9,10],
    [10,4,7,5,9,6,3,12,5,15,1,12,5,11,6,1,12,5,3,2,10,8,12,5,9,10,10,2,10],
    [12,3,14,5,3,8,12,5,3,8,6,7,3,10,14,5,5,3,10,10,12,3,6,5,1,12,11,10,10],
    [2,10,12,1,12,5,5,3,12,7,9,10,8,10,10,6,3,10,12,13,1,10,14,7,5,5,11,10,8],
    [10,12,7,5,3,6,5,9,2,10,2,12,3,12,9,10,8,12,5,5,7,9,10,12,5,1,14,9,2],
    [12,5,13,1,12,9,4,5,13,13,13,1,12,5,5,13,5,5,5,5,13,1,12,5,1,4,13,5,9]]
}
