{
    "width":60,
    "height":60,
    "start":[0,0],
    "end":[59,59],
    "board":[[2,6,3,6,5,5,3,6,5,5,3,6,5,5,5,5,5,5,3,6,5,5,5,5,3,6,5,5,5,3,6,5,3,6,5,5,5,5,5,5,5,3,6,5,5,5,5,3,2,6,5,5,5,5,3,6,5,5,5,3],
    [10,10,10,10,4,3,10,10,6,3,10,14,5,5,5,3,6,3,10,10,4,5,5,5,13,11,6,5,3,10,14,3,12,13,5,5,3,6,5,3,6,9,10,6,7,5,3,10,10,10,6,5,5,3,10,10,6,5,3,10],
    [10,10,10,12,5,9,10,10,10,10,10,12,5,5,1,10,10,8,10,10,6,5,5,5,3,10,12,1,10,10,10,14,5,5,5,1,8,12,3,8,10,6,9,10,10,6,9,10,10,10,12,5,1,12,9,10,10,2,10,10],
    [10,10,12,5,7,5,9,12,9,10,14,5,5,5,5,9,14,3,10,10,10,6,5,1,10,12,5,5,9,10,10,10,6,5,5,5,5,3,12,3,10,10,2,10,10,12,1,10,10,12,7,5,5,3,6,9,10,10,12,9],
    [10,12,5,3,10,6,3,6,5,9,10,6,5,5,5,3,10,10,10,10,10,10,6,3,10,6,5,5,5,9,8,10,10,6,5,5,3,10,6,11,10,10,10,10,12,5,5,9,14,1,12,5,3,14,9,2,12,13,5,1],
    [12,5,3,10,10,10,10,12,7,1,10,10,6,5,3,10,10,10,10,10,10,10,10,10,10,12,5,5,5,5,5,9,10,10,6,3,10,10,10,10,10,10,14,9,6,5,5,1,12,5,5,5,11,10,6,11,6,5,5,3],
    [6,3,10,10,12,9,12,3,12,1,10,10,10,2,10,10,8,10,10,10,10,10,10,10,12,5,5,5,5,5,5,5,9,10,10,8,10,10,10,10,10,10,12,5,9,6,5,3,6,5,5,5,9,10,10,12,15,3,2,10],
    [10,10,10,12,5,5,3,12,5,5,9,10,10,10,10,10,6,9,14,9,10,10,10,10,6,7,1,6,5,3,6,5,5,9,12,5,9,10,10,12,9,14,5,5,5,11,6,11,10,2,6,5,5,9,12,1,10,10,10,10],
    [10,8,12,5,5,3,10,6,3,6,5,9,10,14,9,10,10,2,12,3,10,10,10,10,10,10,6,9,2,10,10,6,5,5,5,5,3,10,14,5,3,12,5,7,3,10,10,10,12,11,10,6,5,5,5,3,10,10,10,10],
    [14,3,6,5,3,10,10,10,10,10,6,5,9,12,1,10,10,14,3,10,10,10,10,12,9,10,12,3,10,10,10,12,5,3,4,5,9,10,10,2,10,6,1,10,10,10,10,10,2,10,10,10,4,5,5,9,10,10,10,10],
    [10,10,10,2,10,10,10,10,10,10,10,6,3,6,5,9,14,9,10,10,10,14,11,6,3,10,2,10,10,10,12,5,5,13,5,7,5,11,10,10,10,14,5,9,8,10,10,10,12,9,10,14,5,5,5,5,9,12,11,10],
    [10,10,10,10,10,10,14,9,10,10,10,10,10,10,6,5,9,4,9,10,10,10,10,10,12,9,10,10,10,12,5,3,6,5,3,14,3,10,10,10,10,12,5,5,1,10,10,14,5,5,11,12,5,5,5,5,5,1,8,10],
    [10,10,10,10,10,10,10,2,10,10,10,10,10,10,10,2,6,5,5,9,10,10,10,12,5,5,9,12,9,6,7,9,12,1,12,9,10,10,10,10,14,5,5,5,5,9,10,8,4,5,13,5,5,5,5,5,5,5,7,9],
    [10,12,13,9,10,10,10,10,10,10,10,10,10,10,10,10,10,6,3,2,10,10,12,5,5,5,5,5,5,9,12,5,5,5,5,5,9,10,10,10,12,5,5,3,6,3,12,5,5,5,3,6,5,1,6,5,5,3,10,2],
    [10,6,5,5,9,10,12,9,10,10,10,10,10,10,14,9,10,10,12,11,10,10,6,1,6,3,6,5,5,5,5,5,5,5,5,5,5,9,10,10,6,5,1,10,10,12,5,5,5,3,10,12,5,5,11,4,5,9,10,10],
    [10,10,6,5,5,9,6,5,9,10,10,10,10,10,14,5,9,10,2,10,10,10,14,5,9,10,10,6,1,4,5,3,6,5,5,5,5,3,10,10,12,5,5,9,10,4,5,5,3,10,10,6,3,6,13,5,5,5,9,10],
    [10,10,10,6,3,4,13,5,3,10,10,10,10,10,12,5,5,9,12,9,10,10,12,5,3,10,10,10,6,5,5,9,12,5,5,3,4,9,10,10,6,5,5,3,12,5,5,5,9,10,10,8,10,10,6,5,5,5,5,11],
    [10,10,10,10,12,5,5,5,9,10,10,10,10,12,5,5,5,5,5,3,10,10,4,3,10,10,10,12,13,3,6,5,5,5,3,14,5,5,9,10,10,6,3,10,2,6,5,5,5,11,14,7,9,10,12,3,6,5,1,10],
    [10,10,12,13,5,5,5,5,5,9,10,10,12,5,5,5,5,5,3,10,10,12,5,13,9,10,10,6,3,10,14,3,6,5,13,9,4,5,5,11,10,8,10,10,10,10,6,5,1,10,10,10,2,12,5,9,12,5,5,11],
    [10,12,5,5,3,6,3,4,5,5,11,10,6,5,5,5,5,3,10,10,10,6,3,4,3,10,10,10,10,10,10,10,12,5,5,5,5,5,5,9,10,6,9,10,10,10,12,5,5,9,10,10,10,6,5,5,5,5,3,10],
    [10,4,5,3,10,10,12,5,5,3,10,12,11,4,5,5,5,9,12,11,10,10,12,5,13,9,10,10,10,10,10,10,6,3,6,5,5,5,5,5,9,14,3,10,10,14,7,5,5,5,9,12,9,10,6,5,5,3,10,10],
    [12,5,5,9,10,10,6,7,1,10,12,3,12,5,5,5,5,5,1,10,10,10,2,4,7,1,10,10,10,10,10,14,9,10,10,6,5,5,5,5,5,9,10,10,14,9,10,6,3,6,5,5,3,10,10,6,3,10,10,8],
    [6,5,5,3,10,10,10,10,6,13,3,10,2,6,5,5,5,5,5,9,10,10,10,6,13,5,9,10,12,9,10,10,4,9,10,10,6,1,6,3,6,3,10,10,12,3,10,10,10,12,5,1,10,10,10,8,10,10,14,3],
    [10,6,3,10,10,10,8,12,13,1,10,10,10,10,6,3,6,7,5,1,10,10,10,10,6,7,1,12,5,5,9,12,5,3,10,10,12,5,11,10,10,8,10,10,2,10,10,10,12,5,5,5,9,10,12,5,9,10,10,10],
    [10,10,10,14,9,12,5,5,5,3,10,10,10,10,10,12,11,8,6,5,9,12,9,10,10,10,6,5,1,6,5,5,3,10,10,12,5,5,9,10,14,5,9,10,10,10,10,10,6,5,5,5,5,9,2,6,5,9,10,10],
    [10,10,10,10,6,5,5,5,3,10,10,10,10,10,10,2,12,5,11,6,5,5,1,10,8,10,12,5,3,12,5,3,10,10,10,6,5,5,3,10,12,5,1,10,10,10,10,10,10,6,5,5,5,3,10,10,6,5,9,10],
    [10,8,12,11,10,6,5,3,10,10,10,10,10,10,10,12,5,3,10,10,2,6,3,10,4,15,7,1,12,5,5,9,10,10,10,10,6,3,12,15,5,5,5,9,12,9,12,9,10,10,4,7,3,10,10,10,10,6,3,10],
    [10,6,3,10,10,10,2,10,10,10,10,10,10,10,10,6,5,9,10,10,10,10,10,10,2,10,12,7,5,5,5,5,13,9,10,12,9,12,1,10,6,5,5,5,5,5,5,3,10,12,5,9,8,12,11,10,10,10,10,10],
    [10,10,10,8,10,10,10,10,10,10,10,10,10,10,12,13,5,1,10,10,10,10,10,10,10,12,3,10,4,5,5,5,5,3,10,6,5,5,5,11,10,6,5,3,6,5,3,10,10,6,5,5,5,1,14,11,10,10,12,9],
    [10,10,12,5,13,9,10,10,10,10,8,12,11,12,5,5,5,5,11,10,10,10,10,10,12,5,9,12,5,5,5,5,5,9,10,10,6,7,3,10,10,12,3,10,10,2,10,10,10,10,6,5,5,3,10,10,10,10,6,3],
    [10,10,6,5,5,5,11,10,10,12,5,5,13,3,6,5,5,5,9,10,10,10,10,12,5,5,5,5,5,5,5,5,5,5,9,10,10,10,10,10,14,5,9,10,10,10,10,10,10,12,9,6,3,10,10,10,10,10,10,10],
    [10,10,12,5,5,1,12,9,12,5,5,5,3,10,10,6,5,5,5,9,10,10,10,6,5,5,5,5,5,3,6,5,3,6,5,9,10,10,10,10,8,6,5,9,12,11,10,10,12,5,5,9,10,10,10,10,10,8,8,10],
    [10,10,6,5,5,5,5,5,3,6,5,3,10,10,10,10,6,5,5,5,11,10,10,12,5,5,5,5,3,10,12,1,10,10,4,5,9,10,10,10,6,13,5,5,1,10,10,10,6,5,5,3,10,10,10,10,12,5,5,11],
    [10,10,10,2,6,7,5,1,10,10,6,9,10,10,10,10,14,5,5,1,14,11,10,6,5,5,5,7,9,12,7,5,9,12,5,5,5,9,8,10,12,5,5,5,5,9,10,10,12,5,1,10,10,14,9,12,5,5,3,10],
    [10,10,10,10,10,10,6,3,10,10,10,2,10,10,10,10,10,6,5,7,11,10,10,10,6,5,3,10,6,5,9,4,3,6,5,5,5,5,5,13,5,5,5,5,5,5,9,12,5,5,5,11,10,10,6,5,5,5,11,10],
    [10,10,10,10,10,8,10,10,14,9,12,9,10,12,9,10,8,10,2,10,10,10,10,10,14,3,10,10,12,5,5,5,9,10,2,6,5,5,5,3,6,5,5,3,6,5,5,3,6,5,5,9,10,10,10,4,5,5,9,10],
    [10,10,10,14,13,5,9,10,12,5,5,5,13,5,3,12,5,9,10,10,10,10,10,10,10,10,10,12,5,5,5,5,3,10,10,12,5,5,1,10,10,4,5,9,12,5,3,10,10,6,5,5,9,8,14,5,5,5,5,9],
    [10,10,10,12,5,5,3,12,5,7,5,3,6,5,9,4,7,7,11,10,10,10,10,10,10,10,12,5,5,5,5,3,10,10,14,5,5,5,5,15,15,5,5,5,5,5,11,10,10,10,6,5,5,5,11,6,7,5,5,3],
    [10,10,10,4,5,5,13,5,1,12,3,10,12,5,5,3,10,10,8,10,10,8,10,10,10,10,2,4,5,5,3,10,10,10,10,6,5,5,1,10,10,4,5,3,6,3,10,10,10,10,10,6,5,3,10,10,10,6,7,9],
    [10,10,12,5,5,5,5,5,5,3,10,12,5,5,3,10,10,10,6,9,12,3,10,10,10,10,14,5,5,3,10,10,10,10,10,12,5,5,5,9,12,5,5,9,10,10,8,10,10,10,10,10,2,10,10,10,10,10,12,3],
    [10,10,6,5,5,5,5,7,3,10,14,5,5,1,10,10,10,10,10,6,5,9,8,10,10,10,12,5,3,10,10,10,10,10,12,5,5,5,5,5,5,5,5,3,10,12,5,9,10,10,10,10,10,10,10,10,10,10,6,9],
    [10,10,10,6,5,5,1,10,10,10,12,5,5,3,10,10,10,8,10,10,6,5,5,9,10,10,6,3,10,10,10,10,10,12,5,5,5,5,5,5,5,5,3,10,12,5,5,5,9,10,10,10,10,10,10,10,10,10,12,1],
    [10,14,9,12,5,5,5,11,10,10,6,5,5,11,10,10,12,5,9,10,10,6,5,5,9,10,10,8,10,10,10,10,12,5,5,5,5,5,5,5,5,3,10,10,6,5,5,5,3,10,10,10,10,10,10,10,10,12,5,1],
    [14,13,5,5,5,5,3,10,10,10,10,6,5,9,10,12,5,5,5,9,10,12,5,3,6,9,12,5,9,10,10,12,5,5,5,1,6,3,6,5,1,10,10,10,10,6,5,1,10,10,10,10,10,12,11,10,12,5,5,3],
    [10,6,5,5,5,1,10,10,10,10,10,10,4,5,13,5,5,5,5,3,10,6,5,9,10,6,5,5,5,9,12,5,5,5,5,5,11,10,10,6,5,9,10,10,12,9,6,5,9,10,10,10,12,3,10,8,6,5,3,10],
    [10,12,7,5,5,3,10,8,10,10,10,12,7,5,5,5,5,5,3,10,10,10,6,5,9,10,6,5,5,5,5,5,5,5,3,2,10,10,10,10,6,5,9,12,7,5,9,6,5,9,10,10,2,10,14,7,9,6,9,10],
    [10,2,10,6,3,12,9,6,9,10,12,1,8,6,5,5,5,3,10,10,10,10,10,6,5,13,9,6,5,5,5,5,5,3,10,10,10,10,10,10,10,6,5,3,10,6,3,10,6,5,9,10,12,11,10,10,6,13,3,10],
    [10,10,10,10,12,5,5,9,6,9,6,3,2,14,5,3,4,9,10,10,10,10,10,12,5,1,6,11,6,5,5,5,3,10,10,10,10,10,10,10,10,10,2,10,10,10,10,10,10,4,5,13,5,9,10,10,10,6,9,10],
    [10,10,10,10,2,6,5,5,9,2,10,10,10,14,1,12,5,5,9,10,10,10,12,5,5,5,9,8,10,6,3,2,10,10,10,10,10,10,10,10,10,10,10,10,10,8,10,10,10,6,7,5,5,5,9,10,10,12,3,10],
    [10,10,10,10,10,10,6,7,3,10,10,10,10,10,6,5,5,5,5,9,10,12,5,5,5,5,5,3,10,10,10,10,10,10,10,12,11,10,10,10,10,12,9,12,15,5,9,10,10,10,10,4,5,5,5,9,8,4,9,10],
    [10,10,10,10,10,10,10,10,10,10,10,10,12,11,10,6,5,5,5,5,13,5,5,5,5,5,3,10,10,10,10,10,10,10,12,5,9,10,10,10,10,6,3,6,11,6,3,10,10,10,10,6,5,5,5,5,5,5,5,11],
    [10,10,8,10,10,10,10,10,12,13,9,14,3,8,10,10,6,5,5,5,7,5,5,5,5,3,10,10,14,11,8,10,10,12,5,5,5,9,10,10,10,10,8,10,10,8,10,10,10,10,10,12,5,5,5,5,5,5,3,10],
    [10,14,3,10,10,10,10,12,5,5,1,10,12,5,9,10,10,6,5,3,12,1,6,5,5,9,10,10,10,12,5,9,12,5,5,5,5,5,11,10,10,12,5,9,12,5,9,10,10,10,12,5,5,5,5,5,5,3,10,10],
    [10,10,10,14,9,10,10,6,3,6,5,13,5,5,5,9,10,10,4,13,5,5,15,5,5,5,11,10,10,6,5,5,5,5,5,5,5,3,10,10,12,5,5,5,5,5,5,9,10,12,3,6,5,5,5,5,3,10,10,10],
    [10,10,10,12,3,10,10,8,10,10,2,6,5,5,5,3,8,12,5,1,6,1,12,5,5,3,10,10,10,10,6,5,5,5,5,5,3,10,10,12,5,5,3,6,5,5,5,3,10,6,9,10,6,5,5,5,9,10,10,10],
    [12,9,10,2,10,10,12,5,9,10,10,10,6,5,3,10,6,5,5,3,12,5,5,5,5,9,10,10,10,10,10,6,5,5,5,3,10,10,10,6,5,3,10,12,5,5,3,10,10,12,5,9,10,6,5,5,1,10,10,10],
    [6,1,10,10,10,12,5,5,5,9,10,10,12,3,10,10,12,5,3,14,5,5,5,5,5,5,9,12,11,10,10,10,4,3,6,9,10,10,10,12,3,10,12,5,5,1,10,10,12,5,7,3,10,10,6,5,5,9,10,10],
    [10,6,9,10,10,4,5,5,5,3,10,10,2,8,12,13,5,3,10,10,6,5,5,5,1,6,5,5,9,10,10,12,5,9,14,5,9,10,14,1,10,12,5,5,3,6,9,12,5,5,9,10,10,10,10,6,5,5,9,8],
    [10,12,5,11,14,5,5,5,5,15,11,10,12,5,5,5,5,9,10,10,12,5,5,5,5,9,6,5,5,13,11,6,5,1,12,5,3,10,12,5,13,5,5,1,12,11,6,5,5,5,5,9,8,10,10,12,5,5,5,1],
    [12,5,5,9,8,4,5,5,5,9,8,12,5,5,5,5,5,5,9,12,5,5,5,5,5,5,9,4,5,5,9,12,5,5,5,5,9,12,5,5,5,5,5,5,5,9,8,4,5,5,5,5,5,9,12,5,5,5,5,1]]
}
