{
    "width":13,
    "height":60,
    "start":[6,0],
    "end":[6,59],
    "board":[[2,6,3,4,5,7,3,6,7,5,5,3,6,5,3,6,5,3,4,5,5,3,6,5,5,5,5,5,5,5,5,5,5,5,5,5,5,7,5,5,5,5,5,3,6,5,5,5,5,7,3,6,5,5,5,1,6,3,6,3],
    [10,10,12,5,3,8,12,9,10,6,5,9,10,2,10,10,2,12,5,5,3,10,10,6,5,5,5,5,5,5,5,5,5,3,6,5,5,13,5,5,5,5,3,10,10,6,5,3,2,10,10,10,6,5,5,3,10,10,10,10],
    [14,9,6,3,12,5,5,3,10,10,6,5,9,14,9,10,12,3,6,3,10,10,10,10,6,7,5,5,5,5,5,5,3,10,10,6,5,5,5,5,3,2,10,10,10,12,3,10,10,10,10,10,14,3,2,10,10,10,10,10],
    [14,3,8,12,5,3,6,9,10,10,10,6,3,14,1,12,3,10,10,10,10,12,9,10,10,12,5,5,5,5,5,3,10,10,10,12,5,5,5,3,10,10,10,10,12,3,10,10,10,10,10,10,10,10,10,10,10,14,9,10],
    [10,10,6,5,3,12,11,2,10,10,10,10,8,12,7,3,10,12,9,10,12,5,3,10,12,5,5,5,5,5,3,10,10,10,14,5,5,5,3,10,10,10,10,12,1,10,10,10,10,10,10,10,10,12,9,10,10,12,3,10],
    [8,10,14,1,12,5,9,10,10,10,10,12,5,3,10,8,12,7,3,14,3,2,10,12,5,5,5,5,5,3,10,10,10,10,8,6,5,5,9,10,10,10,12,5,5,9,10,10,10,10,10,10,12,5,3,10,12,3,10,8],
    [4,9,12,5,3,6,5,9,10,10,12,5,3,10,12,5,3,10,10,8,10,10,10,4,7,5,5,5,5,9,10,10,10,12,5,13,5,5,5,9,10,10,6,5,5,5,9,10,10,10,10,12,5,5,11,12,5,9,8,2],
    [4,5,5,3,10,12,3,6,9,12,5,3,10,12,5,7,9,10,12,3,14,9,12,5,13,5,5,5,5,5,9,10,12,5,5,5,5,5,5,3,10,10,10,2,6,5,5,9,12,9,12,5,5,5,9,6,3,6,1,10],
    [6,5,7,11,10,6,9,10,6,5,7,9,10,6,5,9,4,13,1,10,12,5,5,3,6,5,5,5,5,5,3,12,5,5,5,5,5,5,3,10,10,10,10,10,10,6,3,6,5,5,5,7,3,6,3,10,10,14,3,10],
    [10,4,9,12,9,12,5,9,10,6,13,5,9,10,2,6,7,5,3,10,2,6,3,10,12,5,5,5,5,3,12,5,5,5,5,5,5,5,9,10,10,10,10,10,10,10,10,10,6,5,5,9,10,10,10,10,10,10,10,10],
    [14,7,3,4,3,6,5,5,11,14,1,6,5,9,12,9,10,2,10,10,10,10,10,10,4,5,5,5,5,9,6,5,5,5,5,5,5,5,5,9,8,10,10,10,10,10,10,10,10,6,5,5,9,8,10,10,10,10,12,9],
    [8,10,12,3,12,11,2,4,9,12,3,10,4,5,7,5,9,10,12,9,10,10,10,12,5,5,5,5,5,3,14,3,6,5,5,5,5,5,5,5,5,9,10,10,10,8,10,10,10,12,5,5,5,5,9,10,10,12,5,3],
    [4,13,1,12,5,9,12,5,5,5,9,12,5,5,9,4,5,13,5,5,13,9,12,5,5,5,5,5,5,13,9,12,13,5,5,5,5,5,5,5,5,5,9,12,13,5,13,9,12,5,5,5,5,5,5,9,12,5,5,9]]
}
