{
  "width":15,
  "height":15,
  "start":[7,6],
  "end":[7,0],
  "board":[
  	[ 4, 3, 6, 5, 7, 5, 7, 5, 7, 5, 3, 4, 5, 7, 3],
  	[ 6,15, 9, 6,13, 1,10, 2,10, 4,15, 5, 3,10, 8],
  	[ 8,10, 2,10, 6, 5, 9,14,13, 5,11, 2, 8,14, 1],
  	[ 6,11,14, 9,10, 6, 5, 9, 6, 5,11,14, 7,13, 1],
  	[10, 8,12, 5,11,10, 4, 7,11, 4,11, 8,14, 5, 3],
  	[10, 6, 5, 7,15,13, 3,10,14, 5, 9, 4, 9, 2,10],
  	[10,10, 4,13,13, 5, 9,10,12, 5, 5, 5, 3,10,10],
  	[10,14, 5, 5, 5, 5, 1,10, 6, 5, 3, 6, 9,14, 9],
  	[10,10, 4, 3, 6, 5, 5, 9,10, 6,11,10, 6,13, 1],
  	[10,12, 3,12,11, 6, 1, 2,10,10, 8, 8,14, 5, 3],
  	[12, 3,10, 2,10,12, 5,11,10,10, 6, 5,11, 2,10],
  	[ 6, 9,10,10,12, 5, 5,11,10,12,13, 3,14,11,10],
  	[10, 2,10,14, 5, 5, 3,14, 9, 6, 7, 9, 8, 8,10],
  	[12,11, 8,12, 3, 2,10,12, 3,10,12, 5, 5, 3, 8],
  	[ 4,13, 5, 5,13, 9,12, 5,13,13, 5, 1, 4,13, 1]
  ]
}