{
  "width":11,
  "height":20,
  "start":[5,0],
  "end":[5,19],
  "board":[
  	[ 6, 1, 2, 6, 5, 3, 6, 5, 1, 4, 7, 5, 1, 6, 5, 5, 3, 6, 5, 1],
  	[12, 7,13, 9, 2,14,11, 6, 5, 5,15, 5, 7, 9, 4, 5,13,13, 5, 3],
  	[ 6,11, 2, 6,13, 9,12, 9, 4, 7,13, 1,10, 6, 5, 7, 1, 2, 6, 9],
  	[10, 8,12,11, 6, 5, 7, 5, 3, 8, 6, 5,11,10, 4,11, 4,13,13, 3],
  	[12, 5, 5,13, 9, 4, 9, 6,13, 5,13, 1,12,13, 1,12, 5, 5, 3,10],
  	[ 4, 5, 5, 5, 5, 5, 5,13, 7, 5, 5, 5, 5, 5, 5, 5, 5, 5,11,10],
  	[ 2, 2, 6, 5, 5, 1, 2, 2,10, 4, 7, 5, 5, 1, 2, 6, 5, 5,11,10],
  	[12,13,13, 7, 5, 5,13,11,12, 5,11, 6, 5, 5,13,11, 2, 2, 8,10],
  	[ 6, 7, 5, 9, 4, 3, 4,13, 5, 1,10,10, 6, 7, 1, 8,14,13, 1,10],
  	[10,12, 5, 7, 7,13, 5, 7, 5, 1,10,12, 9,12, 5, 7, 9, 2, 6, 9],
  	[12, 1, 4, 9,12, 5, 1,12, 5, 5,13, 5, 5, 5, 5,13, 5,13,13, 1]
  ]
}